111111111111111
100P01EG00000G1
100000000010001
10V010000000001
1G00000G00010V1
111111111111111