111111111111111
1V0PV1EGV00V0G1
100000000010001
10V010000000001
1G00000G00010V1
111111111111111